###################################
#   #    S    #   #   #     # # # #
# # ### ######### # # # ### # # # #
# # #   #           #   #      #  #
# # # ### ######### ##### ### ### #
# # # # #   #     #   #     # # # #
### # # ### # # ### # # # ### # ###
#             #   # # # # #E  #   #
###################################