###################################
#   #         #   #   #     # # #E#
# # ### ######### # # # ### # # # #
# # #   #           #   #      #  #
# # # ### ######### ##### ### ### #
# # # # #   #     #   #     # # # #
### # # ### # # ### # # # ### # ###
#S            #   # # # # #   #   #
###################################
